XXXXXXXXXXXXXXXXXXXXXXXXXX 
XXXXXXXXXXXXXXXXXXXXXXXXXX 
XX     XOOOOOOOOOOOOOO  XX 
XX     XOOOOOOOOOOOOOO  XX 
XX     X         OOOOO  XX 
XX     X         OOOOO  XX 
XX     X         OOOOO  XX 
XX                      XX 
XX                      XX 
XXXXXXXXXXXXXX          XX 
XX                      XX 
XX     OOOOOOOOO   OOOOOXX 
XX     OOOOOOOOO   OOOOOXX 
XX     OOOOOOOOO   OOOOOXX 
XX     OOOOO            XX 
XX     OOOOO            XX 
XX     OOOOO            XX 
XX     OOOOO            XX 
XX     OOOOO            XX 
XOOOOOOOOOOOOOOOOOOOOO  XX 
XOOOOOOOOOOOOOOOOOOOOO  XX 
XOOOOOOOOOOOOOOOOOOOOO  XX 
XX                      XX 
XX                      XX 
XXXXXXXXXXXXXXXXXXXXXXXXXX 
XXXXXXXXXXXXXXXXXXXXXXXXXX  